1111111111
1P01N00001
1101010111
1C00010E11
1111111111