111111111111111111111111111111
10000000000000000000C000000001
100000000000000000000000000001
100000000P00000000000000000001
100000000000000000000000000001
1000000000000000000000000000E1
100000000000000000000000000001
100000000000000000000000000001
100000000000000000000000000001
100000000000000000000000000001
100000000000000000000000000001
100000000000000000000000000001
100000000000000000000000000001
100000000000000000000N000C0001
100000000000000000000000000001
111111111111111111111111111111