1111111111111111111111111111111111111
1P010000000N00000000000000000000000C1
1000001000000000100101010101001101111
10010011111100001001C1C1C1C10011000E1
1111111111111111111111111111111111111
