111111111111111
1P00010000C0001
111101011101101
100000010001001
101111010111011
1000N1010001001
110110011101101
100100100001001
101C010011110N1
10C1100000E10C1
111111111111111